WWWWWWWWWWWWWWWWWWWWWWWWWWWWWWWW
W..............................W
W..............................W
W..............................W
W.........................T....W
W.......WWWWW......WWWWW.......W
W.......W..............W.......W
W.......W..............W.......W
W.......W..............W.......W
W.......W..............W.......W
W..............................W
W..............WW..............W
W..............WW..............W
W..............................W
W.......W..............W.......W
W.......W..............W.......W
W.......W..............W.......W
W.......W..............W.......W
W.......WWWWW......WWWWW.......W
W..............................W
W..............................W
W..P...........................W
W..............................W
WWWWWWWWWWWWWWWWWWWWWWWWWWWWWWWW
